1111111111111111111111111111111111
1E00000000010000000C00000000000001
1010010100100000101001000000010101
1010010010101010001001000000010101
100P000000000000000C00000000000001
1111111111111111111111111111111111
